Plans for CT
Dialogue hard
Send help

CT Days: 5
WCDTornadoH : If tornado happens (night event)

CT Days: 4
WCDEruption : If eruption is to happen (this is just complicated)

CT Days: 3
WCDFarmerAid1 : First heatwave subsidy (sprinklerdrought)
WCDFarmerAid2 : Second heatwave subsidy (sprinklerdrought)
WCDEclipse : Dark Eclipse
WCDHeatwave : Heatwave/Drought
WCDHurricane : Hurricane/Tropical Storm
WCDDryLightning : Dry Lightning
WCDVolcanicAsh : Volcanic Ash
WCDTornadoW : Tornado Watch
WCDAcidRain : Acid Rain
WCDSmogCC : Smog (If CC Route)
WCDSmogJoja : Smog (If Joja Route)
WCDLocust : Locust Swarm
WCDMeatball : A Small Chance of Meatballs
WCDNorthLight : Northern Lights
WCDMeteor : Meteor Shower - Stardust
WCDHeavyRain : Heavy Rain
WCDHail : Hail
WCDBlizzard : Blizzard
WCDMudRain : Nutrient Rich Rain
WCDSandstorm : Sandstorm
WCDWildfire : Wildfire (post dry lightning usually)
WCDLandslide : After heavy rains (night event)
WCDFish : For Hurricane/Tropical Storm (night event)
WCDBigCrop : For Nutrient Rich Rain (night event)
WCDEarthquake : Earthquakes... this is also complicated (night event)

CT Days 2:
WCDFoggy : Foggy weather is random
WCDSleet : Sleet weather is random